NO tests/textures/N.xmp
SO tests/textures/S.xmp
WE tests/textures/W.xmp
EA tests/textures/E.xmp

F 255,255,0
C 255,255,255

11111111111111111111
10000000000000000001
10000000S00000000001
11111111111111111111
