1111111111111111111111111111111111111111111111111111111111111111111111111111111111111111111111111111111111111111111111111111111
1111111111111111111111111111111111111111111111111111111111111111111111111111111111111111111111111111111111111111111111111111111
1111111111100000000000000000000000000000000000000000000000000000000000000000000000000000000000000000000000000000000000000000001111111
1111111111100000000000000000000000000000000000000000000000000000000000000000000000000000000000000000000000000000000000000000001111111
1111111111100000000000000000000000000000000000000000000000000000000000000000000000000000000000000000000000000000000000000000001111111
1111111111100000000000000000000000000000000000000000000000000000000000000000000000000000000000000000000000000000000000000000001111111
1111111111100000000000000000000000000000000000000000000000000000000000000000000000000000000000000000000000000000000000000000001111111
1111111111100000000000000000000000000000000000000000000000000000000000000000000000000000000000000000000000000000000000000000001111111
1111111111100000000000000000000000000000000000000000000000000000000000000000000000000000000000000000000000000000000000000000001111111
1111111111100000000000000000000000000000000000000000000000000000000000000000000000000000000000000000000000000000000000000000001111111
1111111111100000000000000000000000000000000000000000000000000000000000000000000000000000000000000000000000000000000000000000001111111
1111111111100000000000000000000000000000000000000000000000000000000000000000000000000000000000000000000000000000000000000000001111111
1111111111100000000000000000000000000000000000000000000000000000000000000000000000000000000000000000000000000000000000000000001111111
1111111111100000000000000000000000000000000000000000000000000000000000000000000000000000000000000000000000000000000000000000001111111
1111111111100000000000000000000000000000000000000000000000000000000000000000000000000000000000000000000000000000000000000000001111111
1111111111100000000000000000000000000000000000000000000000000000000000000000000000000000000000000000000000000000000000000000001111111
1111111111100000000000000000000000000000000000000000000000000000000000000000000000000000000000000000000000000000000000000000001111111
1111111111100000000000000000000000000000000000000000000000000000000000000000000000000000000000000000000000000000000000000000001111111
1111111111100000000000000000000000000000000000000000000000000000000000000000000000000000000000000000000000000000000000000000001111111
1111111111100000000000000000000000000000000000000000000000000000000000000000000000000000000000000000000000000000000000000000001111111
1111111111100000000000000000000000000000000000000000000000000000000000000000000000000000000000000000000000000000000000000000001111111
1111111111100000000000000000000000000000000000000000000000000000000000000000000000000000000000000000000000000000000000000000001111111
1111111111100000000000000000000000000000000000000000000000000000000000000000000000000000000000000000000000000000000000000000001111111
1111111111100000000000000000000000000000000000000000000000000000000000000000000000000000000000000000000000000000000000000000001111111
1111111111100000000000000000000000000000000000000000000000000000000000000000000000000000000000000000000000000000000000000000001111111
1111111111100000000000000000000000000000000000000000000000000000000000000000000000000000000000000000000000000000000000000000001111111
1111111111100000000000000000000000000000000000000000000000000000000000000000000000000000000000000000000000000000000000000000001111111
1111111111100000000000000000000000000000000000000000000000000000000000000000000000000000000000000000000000000000000000000000001111111
1111111111100000000000000000000000000000000000000000000000000000000000000000000000000000000000000000000000000000000000000000001111111
1111111111100000000000000000000000000000000000000000000000000000000000000000000000000000000000000000000000000000000000000000001111111
1111111111100000000000000000000000000000000000000000000000000000000000000000000000000000000000000000000000000000000000000000001111111
1111111111100000000000000000000000000000000000000000000000000000000000000000000000000000000000000000000000000000000000000000001111111
1111111111100000000000000000000000000000000000000000000000000000000000000000000000000000000000000000000000000000000000000000001111111
1111111111100000000000000000000000000000000000000000000000000000000000000000000000000000000000000000000000000000000000000000001111111
1111111111100000000000000000000000000000000000000000000000000000000000000000000000000000000000000000000000000000000000000000001111111
1111111111100000000000000000000000000000000000000000000000000000000000000000000000000000000000000000000000000000000000000000001111111
1111111111100000000000000000000000000000000000000000000000000000000000000000000000000000000000000000000000000000000000000000001111111
1111111111100000000000000000000000000000000000000000000000000000000000000000000000000000000000000000000000000000000000000000001111111
1111111111100000000000000000000000000000000000000000000000000000000000000000000000000000000000000000000000000000000000000000001111111
1111111111100000000000000000000000000000000000000000000000000000000000000000000000000000000000000000000000000000000000000000001111111
1111111111100000000000000000000000000000000000000000000000000000000000000000000000000000000000000000000000000000000000000000001111111
1111111111100000000000000000000000000000000000000000000000000000000000000000000000000000000000000000000000000000000000000000001111111
1111111111100000000000000000000000000000000000000000000000000000000000000000000000000000000000000000000000000000000000000000001111111
1111111111100000000000000000000000000000000000000000000000000000000000000000000000000000000000000000000000000000000000000000001111111
1111111111100000000000000000000000000000000000000000000000000000000000000000000000000000000000000000000000000000000000000000001111111
1111111111100000000000000000000000000000000000000000000000000000000000000000000000000000000000000000000000000000000000000000001111111
1111111111100000000000000000000000000000000000000000000000000000000000000000000000000000000000000000000000000000000000000000001111111
1111111111100000000000000000000000000000000000000000000000000000000000000000000000000000000000000000000000000000000000000000001111111
1111111111100000000000000000000000000000000000000000000000000000000000000000000000000000000000000000000000000000000000000000001111111
1111111111100000000000000000000000000000000000000000000000000000000000000000000000000000000000000000000000000000000000000000001111111
1111111111100000000000000000000000000000000000000000000000000000000000000000000000000000000000000000000000000000000000000000001111111
1111111111100000000000000000000000000000000000000000000000000000000000000000000000000000000000000000000000000000000000000000001111111
1111111111100000000000000000000000000000000000000000000000000000000000000000000000000000000000000000000000000000000000000000001111111
1111111111100000000000000000000000000000000000000000000000000000000000000000000000000000000000000000000000000000000000000000001111111
1111111111100000000000000000000000000000000000000000000000000000000000000000000000000000000000000000000000000000000000000000001111111
1111111111100000000000000000000000000000000000000000000000000000000000000000000000000000000000000000000000000000000000000000001111111
1111111111100000000000000000000000000000000000000000000000000000000000000000000000000000000000000000000000000000000000000000001111111
1111111111100000000000000000000000000000S00000000000000000000000000000000000000000000000000000000000000000000000000000000000001111111
1111111111100000000000000000000000000000000000000000000000000000000000000000000000000000000000000000000000000000000000000000001111111
1111111111100000000000000000000000000000000000000000000000000000000000000000000000000000000000000000000000000000000000000000001111111
1111111111100000000000000000000000000000000000000000000000000000000000000000000000000000000000000000000000000000000000000000001111111
1111111111111111111111111111111111111111111111111111111111111111111111111111111111111111111111111111111111111111111111111111111
1111111111111111111111111111111111111111111111111111111111111111111111111111111111111111111111111111111111111111111111111111111
1111111111111111111111111111111111111111111111111111111111111111111111111111111111111111111111111111111111111111111111111111111
1111111111111111111111111111111111111111111111111111111111111111111111111111111111111111111111111111111111111111111111111111111
1111111111111111111111111111111111111111111111111111111111111111111111111111111111111111111111111111111111111111111111111111111
1111111111111111111111111111111111111111111111111111111111111111111111111111111111111111111111111111111111111111111111111111111
1111111111111111111111111111111111111111111111111111111111111111111111111111111111111111111111111111111111111111111111111111111
1111111111111111111111111111111111111111111111111111111111111111111111111111111111111111111111111111111111111111111111111111111
1111111111111111111111111111111111111111111111111111111111111111111111111111111111111111111111111111111111111111111111111111111
1111111111111111111111111111111111111111111111111111111111111111111111111111111111111111111111111111111111111111111111111111111
1111111111111111111111111111111111111111111111111111111111111111111111111111111111111111111111111111111111111111111111111111111
1111111111111111111111111111111111111111111111111111111111111111111111111111111111111111111111111111111111111111111111111111111
1111111111111111111111111111111111111111111111111111111111111111111111111111111111111111111111111111111111111111111111111111111
1111111111111111111111111111111111111111111111111111111111111111111111111111111111111111111111111111111111111111111111111111111
1111111111111111111111111111111111111111111111111111111111111111111111111111111111111111111111111111111111111111111111111111111
1111111111111111111111111111111111111111111111111111111111111111111111111111111111111111111111111111111111111111111111111111111
1111111111111111111111111111111111111111111111111111111111111111111111111111111111111111111111111111111111111111111111111111111
1111111111111111111111111111111111111111111111111111111111111111111111111111111111111111111111111111111111111111111111111111111
1111111111111111111111111111111111111111111111111111111111111111111111111111111111111111111111111111111111111111111111111111111
1111111111111111111111111111111111111111111111111111111111111111111111111111111111111111111111111111111111111111111111111111111
1111111111111111111111111111111111111111111111111111111111111111111111111111111111111111111111111111111111111111111111111111111
1111111111111111111111111111111111111111111111111111111111111111111111111111111111111111111111111111111111111111111111111111111
1111111111111111111111111111111111111111111111111111111111111111111111111111111111111111111111111111111111111111111111111111111
1111111111111111111111111111111111111111111111111111111111111111111111111111111111111111111111111111111111111111111111111111111
1111111111111111111111111111111111111111111111111111111111111111111111111111111111111111111111111111111111111111111111111111111
1111111111111111111111111111111111111111111111111111111111111111111111111111111111111111111111111111111111111111111111111111111
1111111111111111111111111111111111111111111111111111111111111111111111111111111111111111111111111111111111111111111111111111111
1111111111111111111111111111111111111111111111111111111111111111111111111111111111111111111111111111111111111111111111111111111
1111111111111111111111111111111111111111111111111111111111111111111111111111111111111111111111111111111111111111111111111111111
1111111111111111111111111111111111111111111111111111111111111111111111111111111111111111111111111111111111111111111111111111111
1111111111111111111111111111111111111111111111111111111111111111111111111111111111111111111111111111111111111111111111111111111
1111111111111111111111111111111111111111111111111111111111111111111111111111111111111111111111111111111111111111111111111111111
1111111111111111111111111111111111111111111111111111111111111111111111111111111111111111111111111111111111111111111111111111111
1111111111111111111111111111111111111111111111111111111111111111111111111111111111111111111111111111111111111111111111111111111
1111111111111111111111111111111111111111111111111111111111111111111111111111111111111111111111111111111111111111111111111111111
1111111111111111111111111111111111111111111111111111111111111111111111111111111111111111111111111111111111111111111111111111111
1111111111111111111111111111111111111111111111111111111111111111111111111111111111111111111111111111111111111111111111111111111
1111111111111111111111111111111111111111111111111111111111111111111111111111111111111111111111111111111111111111111111111111111
1111111111111111111111111111111111111111111111111111111111111111111111111111111111111111111111111111111111111111111111111111111
1111111111111111111111111111111111111111111111111111111111111111111111111111111111111111111111111111111111111111111111111111111
1111111111111111111111111111111111111111111111111111111111111111111111111111111111111111111111111111111111111111111111111111111
1111111111111111111111111111111111111111111111111111111111111111111111111111111111111111111111111111111111111111111111111111111
1111111111111111111111111111111111111111111111111111111111111111111111111111111111111111111111111111111111111111111111111111111
1111111111111111111111111111111111111111111111111111111111111111111111111111111111111111111111111111111111111111111111111111111
1111111111111111111111111111111111111111111111111111111111111111111111111111111111111111111111111111111111111111111111111111111
1111111111111111111111111111111111111111111111111111111111111111111111111111111111111111111111111111111111111111111111111111111
1111111111111111111111111111111111111111111111111111111111111111111111111111111111111111111111111111111111111111111111111111111
1111111111111111111111111111111111111111111111111111111111111111111111111111111111111111111111111111111111111111111111111111111
1111111111111111111111111111111111111111111111111111111111111111111111111111111111111111111111111111111111111111111111111111111
1111111111111111111111111111111111111111111111111111111111111111111111111111111111111111111111111111111111111111111111111111111
1111111111111111111111111111111111111111111111111111111111111111111111111111111111111111111111111111111111111111111111111111111
1111111111111111111111111111111111111111111111111111111111111111111111111111111111111111111111111111111111111111111111111111111
1111111111111111111111111111111111111111111111111111111111111111111111111111111111111111111111111111111111111111111111111111111
1111111111111111111111111111111111111111111111111111111111111111111111111111111111111111111111111111111111111111111111111111111
1111111111111111111111111111111111111111111111111111111111111111111111111111111111111111111111111111111111111111111111111111111
1111111111111111111111111111111111111111111111111111111111111111111111111111111111111111111111111111111111111111111111111111111
