NO default/N.xpm
SO default/S.xpm
WE default/W.xpm
EA default/E.xpm

C 128, 128, 128
F 200, 200, 200

11111111
10000001
10000001
10000001
10000001
10000001
10000001
100S0001
10000001
10000001
10000001
10000001
10000001
10000001
10000001
10000001
10000001
10000001
10000001
10000001
10000001
10000001
10000001
10000001
10000001
10000001
10000001
10000001
10000001
10000001
10000001
10000001
10000001
10000001
10000001
10000001
10000001
10000001
11111111
